"","taxon","fraction.dark","number.total","number.dark","number.known"
"1","Alveolata",0.796290619251993,13048,10390,2658
"2","Apicomplexa",0.900498972703258,6814,6136,678
"3","Ciliophora",0.523901310717039,2594,1359,1235
"4","Amoebozoa",0.675551853394419,2401,1622,779
"5","Arcellinida",0.130952380952381,84,11,73
"6","Dictyostelia",0.35632183908046,174,62,112
"7","Myxogastria",0.240825688073394,436,105,331
"8","Other",1,1,1,0
"9","Glaucophyta",0.263157894736842,19,5,14
"10","Rhodophyceae",0.57034340876721,6319,3604,2715
"11","Euglenozoa",0.674834437086093,1510,1019,491
"12","Fornicata",0.758064516129032,124,94,30
"13","Heterolobosea",0.78705636743215,479,377,102
"14","Jakobida",0.153846153846154,13,2,11
"15","Parabasalia",0.691111111111111,450,311,139
"16","Opisthokonta",0.598128175547076,546953,327148,219805
"17","Choanomonada",0.222222222222222,81,18,63
"18","Mesomycetozoa",0.767441860465116,129,99,30
"19","Apusomonadida",0.541666666666667,24,13,11
"20","Centroheliozoa",0.596491228070175,57,34,23
"21","Cryptophyceae",0.732441471571906,299,219,80
"22","Haptophyta",0.759842519685039,508,386,122
"23","Rhizaria",0.680922633349351,2081,1417,664
"24","Acantharia",0.438356164383562,73,32,41
"25","Cercozoa",0.665813060179257,781,520,261
"26","Foraminifera",0.746104491292392,1091,814,277
"27","Haplosporidia",0.528301886792453,53,28,25
"28","Polycystinea",0.284313725490196,102,29,73
"29","Actinophryidae",0,3,0,3
"30","Bacillariophyta",0.575240919199407,2698,1552,1146
"31","Bicosoecida",0.792207792207792,77,61,16
"32","Chrysophyceae",0.609375,320,195,125
"33","Eustigmatophyceae",0.849462365591398,186,158,28
"34","Labyrinthulomycetes",0.874203821656051,628,549,79
"35","Opalinata",0.636363636363636,11,7,4
"36","Pelagophyceae",0.794520547945205,73,58,15
"37","Phaeophyceae",0.492424242424242,1584,780,804
"38","Phaeothamniophyceae",0.333333333333333,9,3,6
"39","Pinguiophyceae",0.615384615384615,13,8,5
"40","Raphidophyceae",0.44,25,11,14
"41","Synurophyceae",0.365853658536585,123,45,78
"42","Xanthophyceae",0.526041666666667,192,101,91
"43","Porifera",0.571532846715328,2740,1566,1174
"44","Cnidaria",0.512686675366101,6897,3536,3361
"45","Anthozoa",0.568171242438343,4298,2442,1856
"46","Myxozoa",0.317811408614668,859,273,586
"47","Bryophytes",0.101780779858766,6514,663,5851
"48","Lycopodiopsida",0.0833333333333333,552,46,506
"49","Polypodiopsida",0.0801860465116279,5375,431,4944
"50","Acrogymnospermae",0.0833333333333333,1188,99,1089
"51","Amborellales",0,1,0,1
"52","Austrobaileyales",0.09375,64,6,58
"53","Liliopsida",0.105655355954757,30060,3176,26884
"54","Pinidae",0.078804347826087,736,58,678
"55","Magnoliophyta",0.0948853644106945,123391,11708,111683
"56","Hexapoda",0.664049236764711,275079,182666,92413
"57","Collembola",0.862664714494876,3415,2946,469
"58","Protura",0.254901960784314,51,13,38
"59","Diplura",0.561643835616438,73,41,32
"60","Archaeognatha",0.524193548387097,124,65,59
"61","Thysanura",0.55421686746988,83,46,37
"62","Odonata",0.295002031694433,2461,726,1735
"63","Ephemeroptera",0.74187725631769,2770,2055,715
"64","Zoraptera",0.333333333333333,12,4,8
"65","Dermaptera",0.482758620689655,145,70,75
"66","Plecoptera",0.570332480818414,1173,669,504
"67","Orthoptera",0.469910672308416,4254,1999,2255
"68","Mantophasmatodea",0.4,25,10,15
"69","Grylloblattodea",0.682539682539683,63,43,20
"70","Embioptera",0.403846153846154,104,42,62
"71","Phasmatodea",0.336814621409922,383,129,254
"72","Mantodea",0.43485342019544,614,267,347
"73","Blattodea",0.605214152700186,2685,1625,1060
"74","Isoptera",0.606741573033708,1780,1080,700
"75","Psocodea",0.588936170212766,2350,1384,966
"76","Thysanoptera",0.635342185903984,979,622,357
"77","Hemiptera",0.494254969906985,16449,8130,8319
"78","Hymenoptera",0.771429532798331,59439,45853,13586
"79","Raphidioptera",0.243243243243243,74,18,56
"80","Megaloptera",0.548543689320388,206,113,93
"81","Neuroptera",0.559228650137741,1089,609,480
"82","Strepsiptera",0.45625,160,73,87
"83","Coleoptera",0.4928094131319,41304,20355,20949
"84","Trichoptera",0.682588445149143,10091,6888,3203
"85","Lepidoptera",0.676471549854507,91757,62071,29686
"86","Siphonaptera",0.161290322580645,310,50,260
"87","Mecoptera",0.276243093922652,181,50,131
"88","Diptera",0.743160481502102,52087,38709,13378
"89","Pancrustacea",0.660535635081,284074,187641,96433
"90","Mystacocarida",0,2,0,2
"91","Branchiura",0.428571428571429,21,9,12
"92","Pentastomida",0.609756097560976,41,25,16
"93","Ostracoda",0.483870967741935,620,300,320
"94","Malacostraca",0.45757071547421,13222,6050,7172
"95","Copepoda",0.561332250203087,2462,1382,1080
"96","Tantulocarida",0,2,0,2
"97","Facetotecta",0.916666666666667,12,11,1
"98","Cirripedia",0.648109243697479,952,617,335
"99","Ascothoracida",0.166666666666667,6,1,5
"100","Cephalocarida",0.666666666666667,9,6,3
"101","Branchiopoda",0.724182168056446,1559,1129,430
"102","Remipedia",0.363636363636364,33,12,21
"103","Chelicerata",0.639981586876465,23896,15293,8603
"104","Araneae",0.581095685426885,12029,6990,5039
"105","Scorpiones",0.328787878787879,660,217,443
"106","Pseudoscorpiones",0.715976331360947,338,242,96
"107","Myriapoda",0.472275334608031,1569,741,828
"108","Diplopoda",0.465859030837004,908,423,485
"109","Chilopoda",0.45144804088586,587,265,322
"110","Mollusca",0.399942728964826,20953,8380,12573
"111","Bivalvia",0.453360080240722,3988,1808,2180
"112","Gastropoda",0.38452787258248,15822,6084,9738
"113","Cephalopoda",0.513706793802145,839,431,408
"114","Scaphopoda",0.129032258064516,31,4,27
"115","Polyplacophora",0.141592920353982,226,32,194
"116","Monoplacophora",0.333333333333333,6,2,4
"117","Solenogastres",0.391304347826087,23,9,14
"118","Caudofoveata",0.384615384615385,13,5,8
"119","Actinopterygii",0.386869178367858,28772,11131,17641
"120","Acanthuriformes",0.14,100,14,86
"121","Acipenseriformes",0.305084745762712,59,18,41
"122","Albuliformes",0.535714285714286,28,15,13
"123","Alepocephaliformes",0.0526315789473684,57,3,54
"124","Amiiformes",0,1,0,1
"125","Anabantiformes",0.269076305220884,249,67,182
"126","Anguilliformes",0.465703971119134,554,258,296
"127","Argentiniformes",0.142857142857143,42,6,36
"128","Ateleopodiformes",0.181818181818182,11,2,9
"129","Atheriniformes",0.369565217391304,414,153,261
"130","Aulopiformes",0.504,250,126,124
"131","Batrachoidiformes",0.408163265306122,49,20,29
"132","Beloniformes",0.347280334728033,239,83,156
"133","Beryciformes",0.539473684210526,152,82,70
"134","Blenniiformes",0.235398230088496,565,133,432
"135","Carangiformes",0.213114754098361,183,39,144
"136","Centrarchiformes",0.0436507936507936,252,11,241
"137","Chaetodontiformes",0.189473684210526,190,36,154
"138","Characiformes",0.482662192393736,1788,863,925
"139","Cichliformes",0.545981772990886,2414,1318,1096
"140","Clupeiformes",0.393939393939394,396,156,240
"141","Cypriniformes",0.330012453300125,4015,1325,2690
"142","Cyprinodontiformes",0.213286713286713,1144,244,900
"143","Elopiformes",0.428571428571429,14,6,8
"144","Ephippiformes",0,11,0,11
"145","Esociformes",0.210526315789474,19,4,15
"146","Gadiformes",0.276657060518732,347,96,251
"147","Galaxiiformes",0.111111111111111,72,8,64
"148","Gobiiformes",0.332868108862526,1433,477,956
"149","Gonorynchiformes",0.407407407407407,27,11,16
"150","Gymnotiformes",0.358208955223881,201,72,129
"151","Hiodontiformes",0,2,0,2
"152","Holocentriformes",0.264705882352941,68,18,50
"153","Carangaria",0.307416267942584,836,257,579
"154","Eupercaria",0.40028880866426,6925,2772,4153
"155","Ovalentaria",0.381120178041543,5392,2055,3337
"156","Istiophoriformes",0.25,16,4,12
"157","Kurtiformes",0.152380952380952,210,32,178
"158","Labriformes",0.0992217898832685,514,51,463
"159","Lampridiformes",0.5,34,17,17
"160","Lepidogalaxiiformes",0,1,0,1
"161","Lepisosteiformes",0.363636363636364,11,4,7
"162","Lobotiformes",0,6,0,6
"163","Lophiiformes",0.310526315789474,190,59,131
"164","Mugiliformes",0.317307692307692,104,33,71
"165","Myctophiformes",0.398648648648649,296,118,178
"166","Notacanthiformes",0.238095238095238,21,5,16
"167","Ophidiiformes",0.401129943502825,177,71,106
"168","Osmeriformes",0.450704225352113,71,32,39
"169","Osteoglossiformes",0.472868217054264,258,122,136
"170","Pempheriformes",0.325581395348837,129,42,87
"171","Perciformes",0.557998483699773,3957,2208,1749
"172","Percopsiformes",0.25,16,4,12
"173","Pholidichthyiformes",0,1,0,1
"174","Pleuronectiformes",0.366548042704626,562,206,356
"175","Polymixiiformes",0.4,10,4,6
"176","Polypteriformes",0.25,16,4,12
"177","Salmoniformes",0.460966542750929,269,124,145
"178","Scombriformes",0.278625954198473,262,73,189
"179","Siluriformes",0.389784024682893,2917,1137,1780
"180","Spariformes",0.11864406779661,236,28,208
"181","Stomiatiformes",0.555900621118012,322,179,143
"182","Stylephoriformes",0,1,0,1
"183","Synbranchiformes",0.333333333333333,117,39,78
"184","Syngnathiformes",0.560583941605839,685,384,301
"185","Tetraodontiformes",0.34675615212528,447,155,292
"186","Uranoscopiformes",0.120481927710843,83,10,73
"187","Zeiformes",0.388888888888889,36,14,22
"188","Sarcopterygii",0.193665242429872,32298,6255,26043
"189","Amphibia",0.328045606642707,8069,2647,5422
"190","Aves",0.0371747211895911,9415,350,9065
"191","Lepidosaurs",0.158464034613304,7396,1172,6224
"192","Testudines",0.127710843373494,415,53,362
"193","Crocodilia",0.264705882352941,34,9,25
"194","CYCLOSTOMATA",0.456043956043956,182,83,99
"195","Myxiniformes",0.361702127659574,47,17,30
"196","Petromyzontiformes",0.563106796116505,103,58,45
